###################################################
###################...#.........###################
###################.#.+.........###################
###################.###.........###################
###################.###.........###################
#...+.#.....#.....#...#.........###################
#...#.#.###.#.###.###.#.........###################
#...#.#.#...#...#...#.#.........#......############
#+###.#.#.#####.###.#.#.........+.####+############
#...#...#.....#.###.#.#.........###.............###
#...#######+#.#.###.#.#.........###.............###
#...#.......#...###.#.#.........###.............###
#...#.......##+####.#.#.........###.............###
#...#.......#.....#...#.........###.............###
#####.......#.....#####.........###.............###
#####.......#.....#####.........###.............###
#####.......#.....#################.............###
#####.......#.....#...#####.......#.............###
#####.......#######...#####.......#######+#########
#...#.......###...#...#####.......###.........#...#
#...#######+###...#...#####.......###.........#...#
#...+.....+...#...+...#####.......###.........#...#
###+####+##...+...##########+########.........#...#
###...#...#...#...###...####..#...+.#.........#...#
###...#...######+####.#.#####.#...#.#####+#######+#
###...#...######......#.......#...#...............#
###################################################

