###################################################
#.#.....#.........#.#.#.....#...#.........#.......#
#.#.#.###.........#.#.#.....#.#.###.#####.#.###.#.#
#...#...#.........#.#.#.....#.#...#.#...#.#.#.#.#.#
###.#...#.........#.#.......#.###.#.#.#.#.#.#.#.###
#...#...#.........#...#.....#...#...#.#...#.#.#...#
#.#######.........######.####.#.###########.#.###.#
#.#.....#.........#.........#.#.#.........#...#.#.#
#.#####.#.........#...........#.#.........###.#.#.#
#.#...#.#.........#.........#.#.#.........#.....#.#
#.#.#.#.#...................###.#.........#.#####.#
#...#.#.#.........#.........#...#.........#.#...#.#
#####.#.#.........#.........#.###.#########.#...#.#
#.......#.........#.........#...............#...#.#
#######.#.........#.........#.################.##.#
#.....#.#.........#.........#.#.#...............#.#
#.....#.#.........#.........#.#.#...............#.#
#.....#.#.........#.........#...#.................#
#.#####.###########.........###.#...............#.#
#.........#.....#.#.........#...#...............#.#
#.######.##.....#.#.#####.#####.#...............#.#
#.#...#...#.......#...#...#.#...#...............#.#
#.#...#...#.....#.#...#...#.#...#...............#.#
#.#...#...#.....#.#...#...#.#...#...............#.#
#.###.###########.#########.#####################.#
#.................................................#
###################################################

