###################################################
#########.........#####.....#######################
#########.........#####.....#######################
#####...#.........#####.....#######################
#####...#.........#####.....#######################
#####...#.........#####.....#######################
#########.........#################################
#########.........#.........#####.........#########
#########.........#.........#####.........#########
#########.........#.........#####.........#########
#########.........#.........#####.........#########
#########.........#.........#####.........###...###
#########.........#.........#################...###
#########.........#.........#################...###
#########.........#.........#######################
#.....###.........#.........#####...............###
#.....###.........#.........#####...............###
#.....###.........#.........#####...............###
###################.........#####...............###
###########.....###.........#####...............###
###########.....#################...............###
###...#...#.....###...#...###...#...............###
###...#...#.....###...#...###...#...............###
###...#...#.....###...#...###...#...............###
###################################################
###################################################
###################################################

