###################################################
###################################################
###################################################
###################################################
###################################################
###################################################
###################################################
###################################################
###################################################
###################################.............###
###################################.............###
###############.....###############.............###
###############.....###############.............###
#.....#########.....#####.......###.............###
#.....#########.....#####.......###.............###
#.....#########.....#####.......###.............###
###############.....#####.......###.............###
#######.....###.....#####.......###.............###
#######.....###.....#####.......###################
#######.....###.....#####.......#...###############
#######.....#############.......#...###############
#...###.....#######...###.......#...###############
#...###.....#######...###.......###################
#...###.....###...#...###.......#...###...###.....#
###############...###############...###...###.....#
###############...###############...###...###.....#
###################################################

