###################################################
#.#...........#.......#.........#...#.#.......#...#
#.#.#########.#.###.#.+.........###.#.#.#.###.###.#
#...#.........#...#.#.#.........#...#...#.#.#.#...#
#####.#############.###.........#.#######.#.#.#.#.#
#...+.#.....#.....#...#.........#.....#...#.#...#.#
#...#.#.###.#.###.###.#.........#####.#.###.#####.#
#...#.#.#...#...#...#.#.........#.......#.........#
#+###.#.#.#####.###.#.#.........+.####+##########.#
#...#...#.....#.#.#.#.#.........#.#.............#.#
#...#######+#.#.#.#.#.#.........#.#.............#.#
#...#.......#...#...#.#.........#.#.............#.#
#...#.......##+####.#.#.........#.#.............#.#
#...#.......#.....#...#.........#.#.............#.#
#####.......#.....###.#.........#.#.............#.#
#.#.#.......#.....#...#.........#.#.............#.#
#.#.#.......#.....#################.............#.#
#...+.......#.....#...#.#.#.......#.............#.#
#####.......#######...#.#.#.......#######+#########
#...#.......+.#...#...#...#.......#.#.........#...#
#...#######+###...#...###.#.......#.#.........#...#
#...+.....+...#...+...#.#.#.......#.#.........#...#
###+####+##...+...#####.#.##+######.#.........#...#
#.#...#...#...#...#.#...#.#...#...+.#.........#...#
#.#...#...######+##.#.#.#.###.#...#.#####+#######+#
#.+...#...#...........#.......#...#...............#
###################################################

