###################################################
#...#.....#.........#.....#...#.......#.....#.....#
###.#.###.#.#.#####.#.#.#.###.#.###.###.#.#.#.###.#
#.#...#...#.#.#...#.#.#.#...#.....#.....#.#.#...#.#
#.#####.#####.###.#.#.#.###.#########.###.#.#####.#
#.....#.......#...#.#.#.#.#...#.....#.#...#.......#
#.###.#########.###.###.#.###.#.###.###.#########.#
#...#.....#.........#...#...#...#.#...#.........#.#
#.#.#######.#########.#####.#####.###.#########.#.#
#.#.....#...#.........#...#.........#.....#.....#.#
#.#####.#.###.#####.###.#.#######.#.#####.#.#####.#
#.....#.#...#.....#.....#.......#.#.......#.#...#.#
#####.#.###.#######.###########.###.#######.###.#.#
#...#.#...#.......#.....#.....#...#...#.#.....#.#.#
#.###.###.#######.#####.#.#######.###.#.#.###.#.#.#
#.....#.......#.#.#.....#.....#...#...#.....#.#...#
#######.#####.#.#.###.#######.#.###.###.#####.#.###
#.......#.#.....#...#.....#...#...#.#...#.....#.#.#
#.#######.#.#######.#####.#.#####.#.#.###.#####.#.#
#...#...#.#...#...#.#.......#.....#.#.#...#...#...#
#.#.#.#.#.#.###.#.#.#.#######.#####.#.#.#####.###.#
#.#...#.#...#...#...#.#.......#.#...#.#.#.....#...#
#######.#####.#######.#.#######.#.#####.#.#####.###
#.......#.....#.....#.#.#.#.......#...#.#.#.....#.#
#.#######.#######.#.###.#.#.#######.#.#.#.#.#####.#
#.................#.....#...........#...#.........#
###################################################

