###################################################
#...#...#.......#.............#.......#...#.......#
###.#.#.#.#####.###.#.#######.#.#####.#.#.#.#####.#
#.#...#...#...#...#.#.#.......#.#...#...#.#...#...#
#.#########.#####.#.#.#.#######.#.#.#####.###.#.###
#.........#.#.....#.#.#.#.......#.#.......#...#...#
#####.###.#.#.#######.#.#.#######.###############.#
#.....#.#...#.#...#...#...#.#...#.......#.....#...#
#.#####.#.###.#.#.#.#######.#.#.#######.#.###.#.#.#
#.....#.#.#...#.#...#...#.....#...#.#...#.#.....#.#
#.###.#.#.#.###.#####.#.#.#####.#.#.#.###.#######.#
#.#...#.#.#.....#.#...#.#.#...#.#...#.#.....#.#...#
#.#.###.#.#######.#.###.#.#.#.#.#####.#####.#.#.###
#.#...#.......#.#...#.#...#.#.#.....#.......#...#.#
#.###.#######.#.#.###.#######.#####.#########.###.#
#...#.......#...#.................#...#.....#.#...#
###.#######.#.###################.#.###.#.###.#.#.#
#.#.......#.#.#.......#...#.......#.....#...#...#.#
#.#######.#.###.###.#.###.#.###############.#####.#
#.#.....#.#.....#.#.#.....#.....#.........#.......#
#.#.###.#.#######.#.#####.#####.#.#######.#########
#...#...#.#.#.....#.....#.#.....#...#...#...#.....#
#.###.###.#.#.###.#####.###.#######.#.#.#.#.#.#####
#...#.....#.....#...#...#...#.......#.#.#.#.#.....#
###.###############.#.###.###########.#.#.#.#####.#
#...................#.................#...#.......#
###################################################

