#################
#...#...#.......#
###.#.#.#.#####.#
#.#...#...#.#...#
#.#########.#.###
#.......#.....#.#
#.###.###.#####.#
#.#.#.#...#...#.#
#.#.#.#.###.#.#.#
#...#.......#...#
#################

