###################################################
#######################.........###################
#######################.........###################
#######################.........###################
#######################.........###################
#...###################.........###################
#...###################.........###################
#...###################.........###################
#######################.........###################
#...###################.........###.............###
#...###################.........###.............###
#...#.......###########.........###.............###
#...#.......###########.........###.............###
#...#.......#.....#####.........###.............###
#####.......#.....#####.........###.............###
#####.......#.....#####.........###.............###
#####.......#.....#################.............###
#####.......#.....#...#####.......#.............###
#####.......#######...#####.......#################
#...#.......###...#...#####.......###.........#...#
#...###########...#...#####.......###.........#...#
#...#######...#...#...#####.......###.........#...#
###########...#...###################.........#...#
###...#...#...#...#############...###.........#...#
###...#...#####################...#################
###...#...#####################...#################
###################################################

